x x x x x x x x x x x x x x x x x x x x
x           r2      r                 x
x     d                         d   r x
x h2    x x x x x     x x x x x       x
x       x                     x   h3  x
x   d   x                     x       x
x                                     x
x   e4              p             d   x
x                                     x
x   r   x                     x     c5x
x       x                     x       x
x       x x x x x     x x x x x     r2x
x                             d       x
x   r2      d       d2              t3x
x x x x x x x x x x x x x x x x x x x x
