x x x x x x x x x x x x x x x x x x x x
x                                     x
x                     d               x 
x     p                     x x x     x
x                           x t2x     x
x                 d2        x x x     x
x                                     x
x                 @1        r3        x
x                                     x
x     x x x   d             x x x     x
x     x r2x       e4    d   x r x     x
x     x x x                 x x x     x
x   c5            r2              c2  x
x                                   t2x
x x x x x x x x x x x x x x x x x x x x
